#############################=######################
#+   #      #      # #  #        #     #           #
#    #      #      #  #  #       #            #    #
#    #      #      #   #  #      #            #    #
=    #   ####   ####    #  #     #            #    #
#        #         ######                     #    #
#####              #                      ##########
#   #########   ####   ##                 #        #
#   #              #   ##          #      #        #
#   #              #   ##          #               #
#       #     ######               #      ######   #
#       #          #########       #           #   #
#####   #######               #    #        #  #   #
#       #     #               #    #        #  ##  #
#             #                                    #
#             #     0                              #
#             #                                    =
#                               ####################
#                                                  #
#             #                                    #
#             #                                    #
#############   #######################     ########
#         #           ####                         #
#         #              #########                 #
#         #              #                   #######
=         #              #                         #
#         #                         ##  ##         #
#####  ####                                        #
#                         #         ######         #
#####################=##############################