#############################=######################
#+   #      #      # #  #        #     #           #
# 0  #      #      #  #  #       #       ?    #    #
#    #      #      #   #  #      #            #    #
=    #   ####   ####    #  #     #            #    #
#        #         ######                     #    #
#####              #                      ##########
#   #########   ####   ##                 #        #
#   #              #   ##          #      #   ?    #
#   #              #   ##          #               #
#       #     ######               #      ######   #
#       #          #########       #           #   #
#####   #######               #    #        #  #   #
#       #     #               #    #        #  ##  #
#             #                                    #
#             #     0                              #
#             #                                    =
#                               ####################
#     ?                                            #
#             #                          ?         #
#             #                                    #
#############   #######################     ########
#         #           ####                         #
#   ?     #              #########                 #
#         #     ?        #                   #######
=         #              #                         #
#         #                         ##  ##         #
#####  ####                                        #
#                         #         ######         #
#####################=##############################